"filename", "language", "Java", "comment", "blank", "total"
"/Users/pablo/Cal_poly_classes/308/CSC_308_Final/src/Arrow.java", "Java", 45, 27, 10, 82
"/Users/pablo/Cal_poly_classes/308/CSC_308_Final/src/Block.java", "Java", 82, 39, 13, 134
"/Users/pablo/Cal_poly_classes/308/CSC_308_Final/src/CallMethodBlock.java", "Java", 28, 17, 5, 50
"/Users/pablo/Cal_poly_classes/308/CSC_308_Final/src/ConditionBlock.java", "Java", 39, 26, 11, 76
"/Users/pablo/Cal_poly_classes/308/CSC_308_Final/src/Draw.java", "Java", 4, 3, 2, 9
"/Users/pablo/Cal_poly_classes/308/CSC_308_Final/src/EndBlock.java", "Java", 21, 18, 4, 43
"/Users/pablo/Cal_poly_classes/308/CSC_308_Final/src/InputOutputBlock.java", "Java", 34, 17, 10, 61
"/Users/pablo/Cal_poly_classes/308/CSC_308_Final/src/InstructionBlock.java", "Java", 26, 8, 5, 39
"/Users/pablo/Cal_poly_classes/308/CSC_308_Final/src/Loader.java", "Java", 82, 22, 8, 112
"/Users/pablo/Cal_poly_classes/308/CSC_308_Final/src/Main.java", "Java", 22, 11, 5, 38
"/Users/pablo/Cal_poly_classes/308/CSC_308_Final/src/MainController.java", "Java", 123, 11, 21, 155
"/Users/pablo/Cal_poly_classes/308/CSC_308_Final/src/MenuBar.java", "Java", 49, 6, 12, 67
"/Users/pablo/Cal_poly_classes/308/CSC_308_Final/src/Repository.java", "Java", 190, 66, 22, 278
"/Users/pablo/Cal_poly_classes/308/CSC_308_Final/src/Saver.java", "Java", 79, 19, 8, 106
"/Users/pablo/Cal_poly_classes/308/CSC_308_Final/src/StartBlock.java", "Java", 32, 15, 11, 58
"/Users/pablo/Cal_poly_classes/308/CSC_308_Final/src/StatusBar.java", "Java", 18, 13, 4, 35
"/Users/pablo/Cal_poly_classes/308/CSC_308_Final/src/VariableDeclarationBlock.java", "Java", 28, 11, 5, 44
"/Users/pablo/Cal_poly_classes/308/CSC_308_Final/src/WorkSpace.java", "Java", 26, 21, 5, 52
"Total", "-", 928, 350, 161, 1439